####################     ##############################################
#%%%%%%%%%%%%%%%%%%%     %%%%%%%%%%%%%%%%%%%%%%%%%%%%%%%%%%%%%%%%%%%%##
##                                                                   ##
##                                                                   ##
##                               ############                        ##
##                               %%%%%%%%%%##                        %%
########################                   %%                         .
##%%%%%%%%%%%%%%%%%%%%%%                                              .
##                                                                   ##
##                                                                   ##
##             ############                    ########################
##             %%%%%##%%%%%                    %%%%%%%%%%%%%%%%%%%%%%##
##                  ##                                               ##
##                  ##                                               ##
##                  ##                                               ##
##                  ##                                               ##
###########################################     #######################